1111111111111111111
11P0CE0001111111111
1111111111111111111
