1111111111111111111
111111P011111111111
1111110C11111111111
